11111111111111111
1P10000M00000C011
10101C000111110C1
1010100C0C0000E11
101010M110000C011
101C10001000010C1
1011101C1M0111111
100C00111C0M00111
11111111111111111