11111111111111111
111100C0P0C001111
11100110001100111
11000110C01100C11
1C0M000000000M0E1
11000001110000011
111000M000M000111
1111000CCC0001111
11111111111111111