11111111111111111
11111111111111111
1111P110011011111
11110010010011111
1111C000M00011111
11110000000E11111
11111111111111111
11111111111111111
11111111111111111